#############################################################################################################################################
##               ##                                                   ##              ##                        ##                         ##
##               ##                                                   ##              ##                                                   ##
######### #########                                                   ##              ##                        ##                         ##
##               ##                        ####    #####################              ##                        ## ##########################      
##               ##                        ##                         ######     #######                        ##          #   ####   ######                           
##               ##                        ##                         ##              ##                        ## ########   #   ## #      #                           
##               ##                        ##                         ##              ##                        ## ####   # ## ##    # #### #                          
##               ##                        #####################      ##              #############      #########     ### ##### # ###    # #        
##               ##                        ##                         ##              ##                        ######  ##       # ######  ##                           
##               ##                        ##                         ##              ##                        ##    #    # #####   #### ###                           
##               ##                        ##                         ##              ##                        ############ #   ###   # ##                            
######### #################### ##############                         ######      #################      #########           # ##### ### #### 
##                                         ##      #####################                                        ## #### ####### #    ###    #        
##                                         ##                         ##                                        ## #   #        # #####  ## #         
##                                         ##                         ##                                        ## # # #### #####       ###                                  
##                                         ##                         ##                                        ## ### #### ########### ## ##         
##                                         ##                                                                   ##                        ###        
###########      ###############################################       ############# ########################################################
###########      ############################                          ############   ###                        ##                        ##                 
###########      ############################                          ############# ####                        ##                        ##
###########      ############################                          ##       ###   ###                        ##                        ##             
###########      ########################################################       #### ##############   #############                        ##                 
##               ########################################################       #                                ##                        ##                 
##               ########################################################                                        ##                        ##               
##       ##                  ##       #       #       #       ##       ##       #                                ##                        ##             
##       ##                                                            ##       #### ##############   #############                        ##             
##       ##                  ##       #       #       #       ##       ############   ###                        ##                        ##               
##       ##                  ###################################       ############# ####                        ##                        ##                 
################################################################       ############   ###                        ##                        ##                 
#############################################################################################################################################

INVENTORY:
xxxxxxxxxxxxxxxxxxxxxxxxx   
x     x     x     x     x
x     x     x     x     x
xxxxxxxxxxxxxxxxxxxxxxxxx